111111111111111111111111111
101001010010000010100100001
101001001010101000100100001
1P0000000C00C000000C0000001
1E00000000000N0C00000C00001
1010010100100C0010100100001
101001001010101000100100001
111111111111111111111111111