111111111111111111111111111111111111111111111111111111111111111111111111111111111
101001010010000010100100000000101001000000000000000000000000000000000000000000001
100000000001000000000000010000000010000000000001000000000001000000000000000000001
100000000000000000000000000000000000000000000000000000000000001100000000000000001
100000E00000000000000000000000000000000000000000000000000000000000000000000000001
10000000000000000C000000000000011000000000000000000000000010000000000000000000001
100000000000000000000000000000000000000000000000000000000010000000000000000000001
10000000000000000000000000000000000000000110000000000000001000C110000000000000001
100000000000000000000000000000000000000000000000000000000010000000000000000000001
10000000000C0000000000000000000000000C0000000000000000011010000000000000000000001
100000000000000000000000000000000000000000000000000000000000000000000000000000001
10000000000C000000000000000011000000000N00000000000000000011000000000000000000001
100000000000000000000000000000000000000000000P00000000000000000000000000000000001
1000000000C00000000000000000000000000000000000000000000000C0000000000000000000001
100000000000000110000000000000C000000C0000000000000000110000000000000000000000001
100000000000000000000000000000000000000000000000000000000000000000000000000000001
100000000000000000000000000000000000000000000000001100000000000000000000000000001
100000000000000000000000000000000000000000000000000000000000000000110000000000001
10000000000000000000000C000000000000000000000000000000000000000000000000000000001
10000000E0000000000000000000000000000001110000000000000C0000000000000000000000001
100000000000000000000000000000000000000000000000000000000000000000000000000000001
111111111111111111111111111111111111111111111111111111111111111111111111111111111