11111111111111
10100101001001
1P0000000C0000
1E00000N000001
10100100101011
11111111111111